I am a dungeon of 7x2
I am the map!
                                                                                                                              
                                                                                                                              
                                                                                                                              
                                                                                                                              
        0               1               2               3               4               5               6                     
          * * * * *       * * * * *       * * * * *       * * * * *       * * * * *       * * * * *       * * * * *           
          * · · · *       * · · · *       * · · · *       * · · · *       * · · · *       * · · · *       * · · · *           
          * · · · *       * · · · · · · · · · · · *       * · · · *       * · · · · · · · · · · · · · · · · · · · *           
          * · · · *       * · · · *       * · · · *       * · · · *       * · · · *       * · · · *       * · · · *           
          * * · * *       * * · * *       * * * * *       * * · * *       * * * * *       * * * * *       * * · * *           
              ·               ·                               ·                                               ·               
              ·               ·                               ·                                               ·               
        7     ·         8     ·         9               1 0   ·         1 1             1 2             1 3   ·               
          * * · * *       * * · * *       * * * * *       * * · * *       * * * * *       * * * * *       * * · * *           
          * · · · *       * · · · *       * · · · *       * · · · *       * · · · *       * · · · *       * · · · *           
          * · · · · · · · · · · · · · · · · · · · *       * · · · · · · · · · · · *       * · · · · · · · · · · · *           
          * · · · *       * · · · *       * · · · *       * · · · *       * · · · *       * · · · *       * · · · *           
          * * * * *       * * * * *       * * * * *       * * * * *       * * * * *       * * * * *       * * * * *           
                                                                                                                              
                                                                                                                              
                                                                                                                              
                                                                                                                              
                                                                                                                              

